20,15
1,1,1,1,1,1,1,1,1,1,1,1,1,1,1,1,1,1,1,1,
1,1,1,1,1,1,1,1,1,1,1,1,1,1,1,1,1,1,1,1,
1,1,1,1,1,1,1,1,1,1,1,11,12,12,12,15,1,1,1,1,
1,1,1,1,1,1,1,1,1,1,1,19,20,20,20,23,1,1,1,1,
1,1,51,52,52,52,55,1,1,1,1,27,28,8,30,31,1,1,1,1,
1,1,59,60,60,60,63,1,1,1,24,35,36,16,38,39,26,1,1,1,
1,1,67,68,8,70,71,24,25,25,66,9,33,17,33,10,34,1,1,1,
1,24,35,36,16,38,39,66,33,33,33,33,10,33,33,57,42,1,1,1,
1,40,58,10,33,33,17,33,33,33,33,57,41,41,41,42,1,1,1,1,
1,1,40,41,58,33,33,33,33,17,57,42,1,1,1,1,1,1,1,1,
1,1,1,1,40,58,10,33,33,57,42,1,1,1,1,1,1,1,1,1,
1,1,1,1,1,40,58,33,17,34,1,1,1,1,1,1,1,1,1,1,
1,1,1,1,1,1,40,58,33,34,1,1,1,1,1,1,1,1,1,1,
1,1,1,1,1,1,1,32,17,34,1,1,1,1,1,1,1,1,1,1,
1,1,1,1,1,1,1,32,9,34,1,1,1,1,1,1,1,1,1,1,
0,0,0,0,0,0,0,0,0,0,0,0,0,0,0,0,0,0,0,0,
0,0,0,0,0,0,0,0,0,0,0,0,0,0,0,0,0,0,0,0,
0,0,0,0,0,0,0,0,0,0,0,0,0,0,0,0,0,0,0,0,
0,0,0,0,0,0,0,0,0,0,0,0,0,0,0,0,0,0,0,0,
0,0,0,0,0,0,0,0,0,0,0,0,0,0,0,0,0,0,0,0,
0,0,0,0,0,0,0,0,0,0,0,0,0,0,0,0,0,0,0,0,
0,0,0,0,0,0,0,0,0,0,0,0,0,0,0,0,0,0,0,0,
0,0,0,0,0,0,0,0,0,0,0,0,0,0,0,0,0,0,0,0,
0,0,0,0,0,0,0,0,0,0,0,0,0,0,0,0,0,0,0,0,
0,0,0,0,0,0,0,0,0,0,0,0,0,0,0,0,0,0,0,0,
0,0,0,0,0,0,0,0,0,0,0,0,0,0,0,0,0,0,0,0,
0,0,0,0,0,0,0,0,0,0,0,0,0,0,0,0,0,0,0,0,
0,0,0,0,0,0,0,0,0,0,0,0,0,0,0,0,0,0,0,0,
0,0,0,0,0,0,0,0,0,0,0,0,0,0,0,0,0,0,0,0,
0,0,0,0,0,0,0,0,0,0,0,0,0,0,0,0,0,0,0,0,
0,0,0,0,0,0,0,0,0,0,0,0,0,0,0,0,0,0,0,0,
0,0,0,0,0,0,0,0,0,0,0,3,6,6,6,7,0,0,0,0,
0,0,0,0,0,0,0,0,0,0,0,0,0,0,0,0,0,0,0,0,
0,0,43,44,44,44,47,0,0,0,0,0,0,0,0,0,0,0,0,0,
0,0,0,0,0,0,0,0,0,0,0,45,46,29,45,46,0,0,0,0,
0,0,0,0,0,0,0,0,0,0,0,53,54,0,53,54,0,0,0,0,
0,0,45,46,69,45,46,0,0,0,0,0,0,0,0,0,0,0,0,0,
0,0,53,54,16,53,54,0,0,0,0,0,0,0,0,0,0,0,0,0,
0,0,0,0,0,0,0,0,0,0,0,0,0,0,0,0,0,0,0,0,
0,0,0,0,0,0,0,0,0,0,0,0,0,0,0,0,0,0,0,0,
0,0,0,0,0,0,0,0,0,0,0,0,0,0,0,0,0,0,0,0,
0,0,0,0,0,0,0,0,0,0,0,0,0,0,0,0,0,0,0,0,
0,0,0,0,0,0,0,0,0,0,0,0,0,0,0,0,0,0,0,0,
0,0,0,0,0,0,0,0,0,0,0,0,0,0,0,0,0,0,0,0,
0,0,0,0,0,0,0,0,0,0,0,0,0,0,0,0,0,0,0,0,
false,false,false,false,false,false,false,false,false,false,false,false,false,false,false,false,false,false,false,false,
false,false,false,false,false,false,false,false,false,false,false,false,false,false,false,false,false,false,false,false,
false,false,false,false,false,false,false,false,false,false,false,true,true,true,true,true,false,false,false,false,
false,false,false,false,false,false,false,false,false,false,false,true,false,false,false,true,false,false,false,false,
false,false,true,true,true,true,true,false,false,false,false,true,true,true,true,true,false,false,false,false,
false,false,true,false,false,false,true,false,false,false,false,true,true,false,true,true,false,false,false,false,
false,false,true,true,true,true,true,false,false,false,false,false,false,false,false,false,false,false,false,false,
false,false,true,true,false,true,true,false,false,false,false,false,false,false,false,false,false,false,false,false,
false,false,false,false,false,false,false,false,false,false,false,false,false,false,false,false,false,false,false,false,
false,false,false,false,false,false,false,false,false,false,false,false,false,false,false,false,false,false,false,false,
false,false,false,false,false,false,false,false,false,false,false,false,false,false,false,false,false,false,false,false,
false,false,false,false,false,false,false,false,false,false,false,false,false,false,false,false,false,false,false,false,
false,false,false,false,false,false,false,false,false,false,false,false,false,false,false,false,false,false,false,false,
false,false,false,false,false,false,false,false,false,false,false,false,false,false,false,false,false,false,false,false,
false,false,false,false,false,false,false,false,false,false,false,false,false,false,false,false,false,false,false,false,
