20,15
0,0,2,2,2,2,2,2,2,2,0,0,0,0,0,0,0,0,0,0,
0,0,2,2,2,2,2,2,2,2,0,0,0,0,0,0,0,0,0,0,
0,0,1,1,1,1,1,1,1,1,0,0,0,0,0,0,0,0,0,0,
0,0,1,1,1,1,1,1,1,1,0,0,0,0,0,0,0,0,0,0,
0,0,1,1,1,1,1,1,1,1,8,8,0,0,0,0,0,0,0,0,
0,0,1,1,1,1,1,1,1,1,0,0,0,0,0,0,0,0,0,0,
0,0,1,1,1,1,1,1,1,1,28,27,0,0,0,0,0,0,0,0,
0,0,1,1,1,1,1,1,1,1,8,8,0,0,0,0,0,0,0,0,
0,0,1,1,1,1,1,1,1,1,8,8,0,0,0,0,0,0,0,0,
0,0,0,0,8,1,1,8,8,8,8,8,0,0,0,0,0,0,0,0,
0,0,0,0,0,0,0,0,0,0,0,0,0,0,0,0,0,0,0,0,
0,0,0,0,0,0,0,0,0,0,0,0,0,0,0,0,0,0,0,0,
0,0,0,0,0,0,0,0,0,0,0,0,0,0,0,0,0,0,0,0,
0,0,0,0,0,0,0,0,0,0,0,0,0,0,0,0,0,0,0,0,
0,0,0,0,0,0,0,0,0,0,0,0,0,0,0,0,0,0,0,0,
0,0,0,0,0,0,0,0,0,0,0,0,0,0,0,0,0,0,0,0,
0,0,0,0,0,0,0,0,0,0,0,0,0,0,0,0,0,0,0,0,
0,0,0,0,0,0,0,0,0,21,0,0,0,0,0,0,0,0,0,0,
0,0,0,40,41,42,43,19,20,0,0,0,0,0,0,0,0,0,0,0,
0,0,0,48,49,50,0,0,0,0,0,0,0,0,0,0,0,0,0,0,
0,0,0,0,0,0,0,0,0,0,0,0,0,0,0,0,0,0,0,13,
0,0,0,45,46,0,0,0,17,0,0,0,0,0,0,0,0,0,0,0,
0,0,0,53,54,0,0,0,25,0,0,0,0,0,0,0,0,0,0,0,
0,0,0,0,0,0,0,0,0,0,0,0,0,0,0,0,0,0,0,0,
0,0,0,0,0,0,0,0,0,0,0,0,0,0,0,0,0,0,0,0,
0,0,0,0,0,0,0,0,0,0,0,0,0,0,0,0,0,0,0,0,
0,0,0,0,0,0,0,0,0,0,0,0,0,0,0,0,0,0,0,0,
0,0,0,0,0,0,0,0,0,0,0,0,0,0,0,0,0,0,0,0,
0,0,0,0,0,0,0,0,0,0,0,0,0,0,0,0,0,0,0,0,
0,0,0,0,0,0,0,0,0,0,0,0,0,0,0,0,0,0,0,0,
0,0,0,0,0,0,0,0,0,0,0,0,0,0,0,0,0,0,0,0,
0,0,0,0,0,0,0,0,0,0,0,0,0,0,0,0,0,0,0,0,
0,0,0,32,33,34,0,11,12,0,0,0,0,0,0,0,0,0,0,0,
0,0,0,0,22,0,0,0,0,0,0,0,0,0,0,0,0,0,0,0,
0,0,0,0,0,0,0,0,0,0,0,0,0,0,0,0,0,0,0,0,
0,0,0,0,0,0,0,0,9,0,0,0,0,0,0,0,0,0,0,0,
0,0,0,0,0,0,0,0,0,0,0,0,0,0,0,0,0,0,0,0,
0,0,0,0,16,16,0,0,0,0,0,0,0,0,0,0,0,0,0,0,
0,0,0,0,0,0,0,0,0,0,0,0,0,0,0,0,0,0,0,0,
0,0,0,0,0,0,0,0,0,0,0,0,0,0,0,0,0,0,0,0,
0,0,0,0,0,0,0,0,0,0,0,0,0,0,0,0,0,0,0,0,
0,0,0,0,0,0,0,0,0,0,0,0,0,0,0,0,0,0,0,0,
0,0,0,0,0,0,0,0,0,0,0,0,0,0,0,0,0,0,0,0,
0,0,0,0,0,0,0,0,0,0,0,0,0,0,0,0,0,0,0,0,
0,0,0,0,0,0,0,0,0,0,0,0,0,0,0,0,0,0,0,0,
false,false,false,false,false,false,false,false,false,false,false,false,false,false,false,false,false,false,false,false,
false,true,true,true,true,true,true,true,true,true,true,false,false,false,false,false,false,false,false,false,
false,true,false,false,false,false,false,false,false,true,true,false,false,false,false,false,false,false,false,false,
false,true,false,true,true,true,false,true,true,false,true,false,false,false,false,false,false,false,false,false,
false,true,false,false,false,false,false,false,false,false,true,false,false,false,false,false,false,false,false,false,
false,true,false,false,false,false,false,false,false,false,true,false,false,false,false,false,false,false,false,false,
false,true,false,false,false,false,false,false,true,false,true,false,false,false,false,false,false,false,false,false,
false,true,false,false,false,false,false,false,false,false,true,false,false,false,false,false,false,false,false,false,
false,true,false,false,false,false,false,false,false,false,true,false,false,false,false,false,false,false,false,false,
false,true,true,true,true,false,false,true,true,true,true,false,false,false,false,false,false,false,false,false,
false,false,false,false,true,true,true,true,false,false,false,false,false,false,false,false,false,false,false,false,
false,false,false,false,false,false,false,false,false,false,false,false,false,false,false,false,false,false,false,false,
false,false,false,false,false,false,false,false,false,false,false,false,false,false,false,false,false,false,false,false,
false,false,false,false,false,false,false,false,false,false,false,false,false,false,false,false,false,false,false,false,
false,false,false,false,false,false,false,false,false,false,false,false,false,false,false,false,false,false,false,false,
