20,15
0,0,0,0,0,0,0,0,0,8,8,8,8,0,0,0,0,0,0,0,
0,0,0,8,8,8,8,8,8,8,8,8,8,8,8,8,8,0,0,0,
0,0,0,8,2,2,3,3,2,4,2,2,3,3,2,2,8,0,0,0,
0,0,0,8,10,10,11,11,10,12,10,10,11,11,10,10,8,0,0,0,
0,0,0,8,1,1,1,1,1,1,1,26,1,1,1,1,8,0,0,0,
0,0,0,8,1,1,1,1,1,1,1,1,1,1,1,1,8,0,0,0,
0,0,0,8,1,1,1,1,1,1,1,1,1,1,1,1,8,0,0,0,
0,0,0,8,1,1,1,1,1,1,1,1,1,1,1,1,8,0,0,0,
0,0,0,8,1,1,1,1,1,1,1,1,1,1,1,1,8,0,0,0,
0,0,0,8,1,1,9,1,1,1,1,1,1,1,1,1,8,0,0,0,
0,0,0,8,1,1,1,1,1,1,1,1,1,1,1,1,8,0,0,0,
0,0,0,8,1,1,1,1,1,1,1,1,1,1,1,1,8,0,0,0,
0,0,0,0,0,0,0,0,0,1,1,0,0,0,0,0,0,0,0,0,
0,0,0,0,0,0,0,0,0,0,0,0,0,0,0,0,0,0,0,0,
0,0,0,0,0,0,0,0,0,0,0,0,0,0,0,0,0,0,0,0,
0,0,0,0,0,0,0,0,0,0,0,0,0,0,0,0,0,0,0,0,
0,0,0,0,0,0,0,0,0,0,0,0,0,0,0,0,0,0,0,0,
0,0,0,0,0,0,0,0,0,0,0,0,0,0,0,0,0,0,0,0,
0,0,0,0,0,0,0,0,0,0,0,18,0,0,0,0,0,0,0,0,
0,0,0,0,0,0,0,0,0,0,25,0,27,0,0,0,0,0,0,0,
0,0,0,0,29,30,31,0,0,0,0,0,0,0,13,0,0,0,0,0,
0,0,0,0,37,38,39,0,0,0,1,0,24,0,0,0,0,0,0,0,
0,0,0,0,0,0,0,0,0,0,0,0,0,0,0,0,0,0,0,0,
0,0,0,0,0,0,6,7,0,0,0,0,0,0,0,0,0,0,0,0,
0,0,0,0,0,6,0,15,0,0,0,0,0,0,0,0,0,0,0,0,
0,0,0,0,0,14,15,0,0,0,0,0,0,0,0,0,0,0,0,0,
0,0,0,0,0,0,0,0,0,0,0,0,0,0,0,0,0,0,0,0,
0,0,0,0,0,0,0,0,0,0,0,0,0,0,0,0,0,0,0,0,
0,0,0,0,0,0,0,0,0,0,0,0,0,0,0,0,0,0,0,0,
0,0,0,0,0,0,0,0,0,0,0,0,0,0,0,0,0,0,0,0,
0,0,0,0,0,0,0,0,0,0,0,0,0,0,0,0,0,0,0,0,
0,0,0,0,0,0,0,0,0,0,0,0,0,0,0,0,0,0,0,0,
0,0,0,0,0,0,0,0,0,0,0,0,0,0,0,0,0,0,0,0,
0,0,0,0,0,0,0,0,0,0,0,0,0,0,0,0,0,0,0,0,
0,0,0,0,21,22,23,0,0,0,0,0,0,0,5,0,0,0,0,0,
0,0,0,0,0,0,0,0,0,0,0,0,16,0,0,0,0,0,0,0,
0,0,0,0,0,0,0,0,0,0,0,0,0,0,0,0,0,0,0,0,
0,0,0,0,0,0,0,0,0,0,0,0,0,0,0,0,0,0,0,0,
0,0,0,0,0,0,0,0,0,0,0,0,0,0,0,0,0,0,0,0,
0,0,0,0,0,0,0,0,0,0,0,0,0,0,0,0,0,0,0,0,
0,0,0,0,0,0,0,0,0,0,0,0,0,0,0,0,0,0,0,0,
0,0,0,0,0,0,0,0,0,0,0,0,0,0,0,0,0,0,0,0,
0,0,0,0,0,0,0,0,0,0,0,0,0,0,0,0,0,0,0,0,
0,0,0,0,0,0,0,0,0,0,0,0,0,0,0,0,0,0,0,0,
0,0,0,0,0,0,0,0,0,0,0,0,0,0,0,0,0,0,0,0,
false,false,false,false,false,false,false,false,false,false,false,false,false,false,false,false,false,false,false,false,
false,false,false,false,false,false,false,false,false,false,false,false,false,false,false,false,false,false,false,false,
false,false,false,false,false,false,false,false,false,false,false,false,false,false,false,false,false,false,false,false,
false,false,false,true,true,true,true,true,true,true,true,true,true,true,true,true,true,false,false,false,
false,false,false,true,false,false,false,false,false,false,false,true,false,false,false,false,true,false,false,false,
false,false,false,true,true,true,true,false,false,false,false,false,false,false,true,false,true,false,false,false,
false,false,false,true,false,false,false,false,false,false,false,false,true,false,false,false,true,false,false,false,
false,false,false,true,false,false,false,false,false,false,false,false,false,false,false,false,true,false,false,false,
false,false,false,true,false,false,false,false,false,false,false,false,false,false,false,false,true,false,false,false,
false,false,false,true,false,false,false,false,false,false,false,false,false,false,false,false,true,false,false,false,
false,false,false,true,false,false,false,false,false,false,false,false,false,false,false,false,true,false,false,false,
false,false,false,true,false,false,false,false,false,false,false,false,false,false,false,false,true,false,false,false,
false,false,false,true,true,true,true,true,true,false,false,true,true,true,true,true,true,false,false,false,
false,false,false,false,false,false,false,false,true,true,true,true,false,false,false,false,false,false,false,false,
false,false,false,false,false,false,false,false,false,false,false,false,false,false,false,false,false,false,false,false,
