20,15
0,0,0,0,0,0,0,0,0,0,0,0,0,0,0,0,0,0,0,0,
0,0,0,0,0,0,0,0,0,0,0,0,0,0,0,0,0,0,0,0,
0,0,0,0,1,1,2,2,1,3,1,1,2,2,1,1,0,0,0,0,
0,0,0,0,9,9,10,10,9,11,9,9,10,10,9,9,0,0,0,0,
0,0,0,0,8,8,8,8,8,8,24,24,8,8,24,24,0,0,0,0,
0,0,0,0,8,8,8,8,8,8,8,8,8,8,8,8,0,0,0,0,
0,0,0,0,8,8,8,17,8,8,8,8,8,8,8,8,0,0,0,0,
0,0,0,0,8,8,8,26,29,27,28,30,8,8,24,24,0,0,0,0,
0,0,0,0,8,8,8,8,8,8,8,8,8,8,8,8,0,0,0,0,
0,0,0,0,8,8,8,8,8,8,8,8,8,8,8,8,0,0,0,0,
0,0,0,0,8,8,8,8,8,8,8,8,8,8,24,24,0,0,0,0,
0,0,0,0,8,8,8,8,8,8,8,8,8,8,8,8,0,0,0,0,
0,0,0,0,0,0,0,0,0,8,8,0,0,0,0,0,0,0,0,0,
0,0,0,0,0,0,0,0,0,0,0,0,0,0,0,0,0,0,0,0,
0,0,0,0,0,0,0,0,0,0,0,0,0,0,0,0,0,0,0,0,
0,0,0,0,0,0,0,0,0,0,0,0,0,0,0,0,0,0,0,0,
0,0,0,0,0,0,0,0,0,0,0,0,0,0,0,0,0,0,0,0,
0,0,0,0,0,0,0,0,0,0,0,0,0,0,0,0,0,0,0,0,
0,0,0,0,0,0,0,0,0,0,0,0,0,0,0,0,0,0,0,0,
0,0,0,0,0,0,0,0,0,0,0,0,0,0,0,0,0,0,0,0,
0,0,0,0,0,0,0,0,0,0,0,0,0,0,0,0,0,0,0,0,
0,0,0,0,0,0,0,0,0,0,0,0,0,0,0,0,0,0,0,0,
0,0,0,0,0,0,0,0,0,0,0,0,0,0,0,0,0,0,0,0,
0,0,0,0,0,0,0,0,0,0,0,0,0,0,0,0,0,0,0,0,
0,0,0,0,0,0,0,0,0,0,0,0,0,0,0,0,0,0,0,0,
0,0,0,0,0,0,0,0,0,0,0,0,0,0,0,0,0,0,0,0,
0,0,0,0,0,0,0,0,0,0,0,0,0,0,0,0,0,0,0,0,
0,0,0,0,0,0,0,0,0,0,0,0,0,0,0,0,0,0,0,0,
0,0,0,0,0,0,0,0,0,0,0,0,0,0,0,0,0,0,0,0,
0,0,0,0,0,0,0,0,0,0,0,0,0,0,0,0,0,0,0,0,
0,0,0,0,0,0,0,0,0,0,0,0,0,0,0,0,0,0,0,0,
0,0,0,0,0,0,0,0,0,0,0,0,0,0,0,0,0,0,0,0,
0,0,0,0,0,0,0,0,0,0,0,0,0,0,0,0,0,0,0,0,
0,0,0,0,0,0,0,0,0,0,16,16,0,0,16,16,0,0,0,0,
0,0,0,0,0,0,0,0,0,0,0,0,0,0,0,0,0,0,0,0,
0,0,0,0,0,0,0,18,0,0,0,0,0,0,0,0,0,0,0,0,
0,0,0,0,0,0,0,0,21,19,20,22,0,0,16,16,0,0,0,0,
0,0,0,0,0,0,0,0,0,0,0,0,0,0,0,0,0,0,0,0,
0,0,0,0,0,0,0,0,0,0,0,0,0,0,0,0,0,0,0,0,
0,0,0,0,0,0,0,0,0,0,0,0,0,0,16,16,0,0,0,0,
0,0,0,0,0,0,0,0,0,0,0,0,0,0,0,0,0,0,0,0,
0,0,0,0,0,0,0,0,0,0,0,0,0,0,0,0,0,0,0,0,
0,0,0,0,0,0,0,0,0,0,0,0,0,0,0,0,0,0,0,0,
0,0,0,0,0,0,0,0,0,0,0,0,0,0,0,0,0,0,0,0,
0,0,0,0,0,0,0,0,0,0,0,0,0,0,0,0,0,0,0,0,
false,false,false,false,false,false,false,false,false,false,false,false,false,false,false,false,false,false,false,false,
false,false,false,false,false,false,false,false,false,false,false,false,false,false,false,false,false,false,false,false,
false,false,false,false,false,false,false,false,false,false,false,false,false,false,false,false,false,false,false,false,
false,false,false,true,true,true,true,true,true,true,true,true,true,true,true,true,true,false,false,false,
false,false,false,true,false,false,false,false,false,false,true,true,false,false,true,true,true,false,false,false,
false,false,false,true,false,false,false,false,false,false,false,false,false,false,false,false,true,false,false,false,
false,false,false,true,false,false,false,true,false,false,false,false,false,false,false,false,true,false,false,false,
false,false,false,true,false,false,false,true,true,true,true,true,false,false,true,true,true,false,false,false,
false,false,false,true,false,false,false,false,false,false,false,false,false,false,false,false,true,false,false,false,
false,false,false,true,false,false,false,false,false,false,false,false,false,false,false,false,true,false,false,false,
false,false,false,true,false,false,false,false,false,false,false,false,false,false,true,true,true,false,false,false,
false,false,false,true,false,false,false,false,false,false,false,false,false,false,false,false,true,false,false,false,
false,false,false,true,true,true,true,true,true,false,false,true,true,true,true,true,true,false,false,false,
false,false,false,false,false,false,false,false,true,true,true,true,false,false,false,false,false,false,false,false,
false,false,false,false,false,false,false,false,false,false,false,false,false,false,false,false,false,false,false,false,
