20,15
1,1,1,1,1,1,1,1,1,1,1,1,1,1,1,1,1,1,1,1,
1,1,1,1,1,1,1,1,1,1,1,1,1,1,1,1,1,1,1,1,
1,1,1,1,1,1,1,1,1,1,1,1,1,1,1,1,1,1,1,9,
1,1,1,1,1,1,1,1,1,1,1,1,1,1,1,1,1,1,1,3,
1,1,1,1,1,1,1,1,1,1,1,1,1,1,1,1,1,1,10,3,
1,1,1,1,1,1,1,1,1,1,1,1,1,1,1,1,1,10,3,3,
1,1,1,1,1,1,1,14,1,1,1,1,1,1,1,9,10,3,3,3,
1,1,1,1,1,1,1,14,1,1,1,1,1,9,10,3,3,3,3,3,
1,1,1,1,1,1,1,14,1,1,1,1,10,3,3,3,3,3,3,3,
1,1,1,1,1,1,1,6,7,1,9,10,3,3,3,3,3,3,3,3,
9,9,9,9,9,9,9,9,15,10,3,3,3,3,3,3,3,3,3,3,
3,3,3,3,3,3,3,3,3,3,3,3,3,3,3,3,3,3,3,3,
3,3,3,3,3,3,3,3,3,3,3,3,3,3,3,3,3,3,3,3,
3,3,3,3,3,3,3,3,3,3,3,3,3,3,3,3,3,3,3,3,
3,3,3,3,3,3,3,3,3,3,3,3,3,3,3,3,3,3,3,3,
37,37,37,37,37,36,36,36,0,0,0,0,0,0,0,36,37,37,36,49,
37,37,37,36,73,74,75,0,0,0,0,0,0,0,36,36,36,36,26,65,
37,37,37,37,81,82,83,0,0,0,0,0,36,36,36,36,49,50,51,0,
37,36,36,36,81,82,83,0,0,0,0,36,36,36,36,26,65,66,67,0,
74,74,74,75,89,90,91,36,0,0,36,36,36,0,0,0,0,0,0,0,
82,82,82,83,36,36,44,44,0,36,36,0,0,0,0,0,0,0,0,0,
90,90,90,91,26,26,0,0,36,36,0,0,0,0,0,0,0,0,0,0,
50,50,51,26,26,0,0,33,0,0,0,0,0,0,0,0,0,0,0,0,
58,60,67,0,0,0,0,0,0,0,0,0,0,0,0,0,0,0,0,0,
66,67,0,0,0,0,0,0,0,0,0,0,0,0,0,0,0,0,0,0,
0,0,0,0,0,0,0,0,0,0,0,0,0,0,0,0,0,0,0,0,
0,0,0,0,0,0,0,0,0,0,0,0,0,0,0,0,0,0,0,0,
0,0,0,0,0,0,0,0,0,0,0,0,0,0,0,0,0,0,0,0,
0,0,0,0,0,0,0,0,0,0,0,0,0,0,0,0,0,0,0,0,
0,0,0,0,0,0,0,0,0,0,0,0,0,0,0,0,0,0,0,0,
0,0,0,0,0,0,0,0,0,0,0,0,0,0,0,0,0,0,0,0,
0,0,0,0,0,0,0,0,0,0,0,0,0,0,0,0,0,0,0,0,
0,0,0,0,0,0,0,0,0,0,0,0,0,0,0,0,0,0,0,0,
0,0,0,0,0,0,0,0,0,0,0,0,0,0,0,0,0,0,0,0,
0,0,0,0,0,0,0,0,0,0,0,0,0,0,0,0,0,0,0,0,
0,0,0,0,0,0,0,0,0,0,0,0,0,0,0,0,0,0,0,0,
0,0,0,0,0,0,0,0,0,0,0,0,0,0,0,0,0,0,0,0,
0,0,0,0,0,0,0,0,0,0,0,0,0,0,0,0,0,0,0,0,
0,0,0,0,0,0,0,0,0,0,0,0,0,0,0,0,0,0,0,0,
0,0,0,0,0,0,0,0,0,0,0,0,0,0,0,0,0,0,0,0,
0,0,0,0,0,0,0,0,0,0,0,0,0,0,0,0,0,0,0,0,
0,0,0,0,0,0,0,0,0,0,0,0,0,0,0,0,0,0,0,0,
0,0,0,0,0,0,0,0,0,0,0,0,0,0,0,0,0,0,0,0,
0,0,0,0,0,0,0,0,0,0,0,0,0,0,0,0,0,0,0,0,
0,0,0,0,0,0,0,0,0,0,0,0,0,0,0,0,0,0,0,0,
false,false,false,false,false,false,false,true,false,false,false,false,false,false,false,true,false,false,false,false,
false,false,false,false,false,false,true,false,false,false,false,false,false,false,true,false,false,false,false,false,
false,false,false,false,false,false,true,false,false,false,false,false,true,true,false,false,false,false,false,false,
false,false,false,false,false,false,true,false,false,false,false,true,false,true,true,true,true,true,true,false,
false,false,false,false,false,false,true,true,false,false,true,true,true,false,false,false,false,false,false,true,
false,false,false,false,false,true,false,false,false,true,true,false,false,false,false,false,false,false,true,false,
false,false,false,false,false,true,false,true,true,true,false,false,false,false,false,false,false,true,false,false,
false,false,false,true,true,false,false,false,false,false,false,false,false,false,false,true,true,false,false,false,
false,false,true,false,false,false,false,true,false,false,false,false,false,true,true,false,false,false,false,false,
true,true,false,false,false,false,false,true,true,false,false,false,true,false,false,false,false,false,false,false,
false,false,false,false,false,false,false,false,true,false,true,true,false,false,false,false,false,false,false,false,
true,true,true,true,true,true,true,true,true,true,false,false,false,false,false,false,false,false,false,false,
false,false,false,false,false,false,false,false,false,false,false,false,false,false,false,false,false,false,false,false,
false,false,false,false,false,false,false,false,false,false,false,false,false,false,false,false,false,false,false,false,
false,false,false,false,false,false,false,false,false,false,false,false,false,false,false,false,false,false,false,false,
