20,15
11,11,11,11,11,11,11,11,11,11,11,11,11,11,11,11,11,11,13,13,
11,11,11,11,11,11,11,11,11,11,11,11,11,11,11,11,11,11,13,13,
11,11,11,11,11,11,11,11,11,11,11,11,11,11,11,11,11,11,13,13,
11,11,11,11,11,11,11,11,11,11,11,11,11,11,11,11,11,11,13,13,
11,11,11,11,11,11,11,11,11,11,11,11,11,11,11,11,11,13,13,13,
11,11,11,11,11,11,11,11,11,11,11,11,11,11,11,11,11,13,13,13,
11,11,11,11,11,64,11,11,11,11,11,11,11,11,11,11,11,13,13,13,
11,11,11,11,11,64,11,11,11,11,11,11,11,11,11,11,11,13,13,13,
11,11,11,11,11,11,11,11,11,11,11,11,11,11,11,11,13,13,13,13,
11,11,11,11,11,11,11,11,11,11,11,64,64,11,11,13,13,13,13,13,
11,11,11,11,11,11,11,11,11,11,11,11,11,11,11,13,13,13,13,13,
13,11,11,11,11,11,11,11,11,11,11,11,11,13,13,13,13,13,13,13,
13,13,11,11,11,11,11,11,11,11,11,13,13,13,13,13,13,13,13,13,
13,13,13,13,13,13,13,13,13,13,13,13,13,13,13,13,13,13,13,13,
13,13,13,13,13,13,13,13,13,13,13,13,13,13,13,13,13,13,13,13,
63,63,63,63,63,62,62,82,82,82,82,82,82,82,82,62,62,34,82,82,
63,63,63,63,62,62,82,82,82,82,82,82,82,82,82,62,62,34,82,82,
62,62,62,62,62,62,82,82,82,82,82,82,82,82,62,62,82,34,82,82,
62,62,62,62,62,62,82,82,82,82,82,82,82,62,62,62,62,42,82,82,
38,38,38,62,62,62,62,82,82,82,82,82,62,62,62,62,34,82,82,82,
38,38,38,82,82,62,44,82,82,82,62,62,62,62,38,38,34,82,82,82,
38,38,38,82,82,82,82,62,62,62,62,62,38,38,38,38,34,82,82,82,
38,38,38,38,82,82,82,82,82,38,38,38,38,38,38,82,42,82,82,82,
38,38,38,38,82,82,82,82,82,82,82,82,82,82,82,42,82,82,82,82,
82,82,38,38,82,82,82,82,82,82,82,82,82,82,34,82,82,82,82,82,
40,82,82,82,82,82,82,38,38,38,82,82,82,41,42,82,82,82,82,82,
82,40,82,82,82,82,38,38,38,82,82,41,42,82,82,82,82,82,82,82,
82,82,40,41,41,41,41,41,41,41,42,82,82,82,82,82,82,82,82,82,
82,82,82,82,82,82,82,82,82,82,82,82,82,82,82,82,82,82,82,82,
82,82,82,82,82,82,82,82,82,82,82,82,82,82,82,82,82,82,82,82,
82,82,82,82,82,82,82,82,82,82,82,82,82,82,82,82,82,82,82,82,
82,82,82,82,82,82,82,82,82,82,82,82,82,82,82,82,82,82,82,82,
82,82,82,82,82,82,82,82,82,82,82,82,82,82,82,82,82,82,82,82,
82,82,82,82,82,82,82,82,82,82,82,82,82,82,82,82,82,82,82,82,
82,82,82,82,82,82,82,82,82,82,82,82,82,82,82,82,82,82,82,82,
82,82,82,82,82,82,82,82,82,82,82,82,82,82,82,82,82,82,82,82,
82,82,82,82,82,82,82,82,82,82,82,82,82,82,82,82,82,82,82,82,
82,82,82,82,82,82,82,82,82,82,82,82,82,82,82,82,82,82,82,82,
82,82,82,82,82,82,82,82,82,82,82,82,82,82,82,82,82,82,82,82,
82,82,82,82,82,82,82,82,82,82,82,82,82,82,82,82,82,82,82,82,
82,82,82,82,82,82,82,82,82,82,82,82,82,82,82,82,82,82,82,82,
82,82,82,82,82,82,82,82,82,82,82,82,82,82,82,82,82,82,82,82,
82,82,82,82,82,82,82,82,82,82,82,82,82,82,82,82,82,82,82,82,
82,82,82,82,82,82,82,82,82,82,82,82,82,82,82,82,82,82,82,82,
82,82,82,82,82,82,82,82,82,82,82,82,82,82,82,82,82,82,82,82,
true,true,false,false,false,false,true,false,false,false,false,false,false,false,false,true,false,false,true,false,
true,true,false,false,false,true,false,false,false,false,false,false,false,false,false,true,false,false,true,false,
true,true,false,false,false,true,false,false,false,false,false,false,false,false,true,false,false,false,true,false,
true,true,false,false,false,true,false,false,false,false,false,false,false,true,false,false,true,false,true,false,
true,true,false,true,true,false,true,false,false,false,false,false,true,true,false,true,false,true,false,false,
true,true,true,false,false,true,false,false,false,false,true,true,false,false,false,true,false,true,false,false,
true,true,true,false,false,false,false,true,true,true,false,false,false,false,false,true,false,true,false,false,
true,true,false,true,false,false,false,false,false,true,true,true,true,true,true,false,false,true,false,false,
true,true,false,true,false,false,false,false,false,false,false,false,false,false,false,false,true,false,false,false,
false,false,true,true,false,false,false,false,false,false,false,false,false,false,false,true,false,false,false,false,
false,false,false,false,false,false,false,true,true,true,false,false,false,false,false,true,false,false,false,false,
true,false,false,false,false,false,true,true,true,false,false,false,false,true,true,false,false,false,false,false,
false,true,false,false,false,false,false,false,false,false,false,true,true,false,false,false,false,false,false,false,
false,false,true,true,true,true,true,true,true,true,true,false,false,false,false,false,false,false,false,false,
false,false,false,false,false,false,false,false,false,false,false,false,false,false,false,false,false,false,false,false,
