20,15
1,1,1,1,1,1,1,1,1,1,1,1,1,1,1,1,1,1,1,1,
1,1,1,1,1,1,1,1,1,1,1,1,1,1,1,1,1,1,1,1,
1,1,1,1,1,1,1,1,1,1,1,1,1,1,1,1,1,1,1,9,
1,1,1,1,1,1,1,1,1,1,1,1,1,1,1,1,1,1,1,3,
1,1,1,1,1,1,1,1,1,1,1,1,1,1,1,1,1,1,10,3,
1,1,1,1,1,1,1,1,1,1,1,1,1,1,1,1,1,10,3,3,
1,1,1,1,1,1,1,14,1,1,1,1,1,1,1,9,10,3,3,3,
1,1,1,1,1,1,1,14,1,1,1,1,1,9,10,3,3,3,3,3,
1,1,1,1,1,1,1,14,1,1,1,1,10,3,3,3,3,3,3,3,
1,1,1,1,1,1,1,6,7,1,9,10,3,3,3,3,3,3,3,3,
9,9,9,9,9,9,9,9,15,10,3,3,3,3,3,3,3,3,3,3,
3,3,3,3,3,3,3,3,3,3,3,3,3,3,3,3,3,3,3,3,
3,3,3,3,3,3,3,3,3,3,3,3,3,3,3,3,3,3,3,3,
3,3,3,3,3,3,3,3,3,3,3,3,3,3,3,3,3,3,3,3,
3,3,3,3,3,3,3,3,3,3,3,3,3,3,3,3,3,3,3,3,
37,37,37,37,37,36,36,36,0,0,0,0,0,0,0,36,37,37,36,26,
37,37,37,36,36,36,36,0,0,0,0,0,0,0,36,36,36,36,26,26,
37,37,37,37,36,36,36,0,0,0,0,0,36,36,36,36,26,26,26,0,
37,36,36,36,36,36,36,0,0,0,0,36,36,36,36,26,26,26,26,0,
36,36,36,36,36,36,36,36,0,0,36,36,36,0,0,0,0,0,0,0,
36,36,36,36,36,36,44,44,0,36,36,0,0,0,0,0,0,0,0,0,
36,36,36,36,26,26,0,0,36,36,0,0,0,0,0,0,0,0,0,0,
36,36,26,26,26,0,0,33,0,0,0,0,0,0,0,0,0,0,0,0,
26,26,26,0,0,0,0,0,0,0,0,0,0,0,0,0,0,0,0,0,
26,26,0,0,0,0,0,0,0,0,0,0,0,0,0,0,0,0,0,0,
0,0,0,0,0,0,0,0,0,0,0,0,0,0,0,0,0,0,0,0,
0,0,0,0,0,0,0,0,0,0,0,0,0,0,0,0,0,0,0,0,
0,0,0,0,0,0,0,0,0,0,0,0,0,0,0,0,0,0,0,0,
0,0,0,0,0,0,0,0,0,0,0,0,0,0,0,0,0,0,0,0,
0,0,0,0,0,0,0,0,0,0,0,0,0,0,0,0,0,0,0,0,
0,0,0,0,0,0,0,0,0,0,0,0,0,0,0,0,0,0,0,0,
0,0,0,0,0,0,0,0,0,0,0,0,0,0,0,0,0,0,0,0,
0,0,0,0,0,0,0,0,0,0,0,0,0,0,0,0,0,0,0,0,
0,0,0,0,0,0,0,0,0,0,0,0,0,0,0,0,0,0,0,0,
0,0,0,0,0,0,0,0,0,0,0,0,0,0,0,0,0,0,0,0,
0,0,0,0,0,0,0,0,0,0,0,0,0,0,0,0,0,0,0,0,
0,0,0,0,0,0,0,0,0,0,0,0,0,0,0,0,0,0,0,0,
0,0,0,0,0,0,0,0,0,0,0,0,0,0,0,0,0,0,0,0,
0,0,0,0,0,0,0,0,0,0,0,0,0,0,0,0,0,0,0,0,
0,0,0,0,0,0,0,0,0,0,0,0,0,0,0,0,0,0,0,0,
0,0,0,0,0,0,0,0,0,0,0,0,0,0,0,0,0,0,0,0,
0,0,0,0,0,0,0,0,0,0,0,0,0,0,0,0,0,0,0,0,
0,0,0,0,0,0,0,0,0,0,0,0,0,0,0,0,0,0,0,0,
0,0,0,0,0,0,0,0,0,0,0,0,0,0,0,0,0,0,0,0,
0,0,0,0,0,0,0,0,0,0,0,0,0,0,0,0,0,0,0,0,
false,false,false,false,false,false,false,true,false,false,false,false,false,false,false,true,false,false,false,false,
false,false,false,false,false,false,true,false,false,false,false,false,false,false,true,false,false,false,false,false,
false,false,false,false,false,false,true,false,false,false,false,false,true,true,false,false,false,false,false,false,
false,false,false,false,false,false,true,false,false,false,false,true,false,true,true,true,true,true,true,false,
false,false,false,false,false,false,true,true,false,false,true,true,true,false,false,false,false,false,false,true,
false,false,false,false,false,true,false,false,false,true,true,false,false,false,false,false,false,false,true,false,
false,false,false,false,false,true,false,true,true,true,false,false,false,false,false,false,false,true,false,false,
false,false,false,true,true,false,false,false,false,false,false,false,false,false,false,true,true,false,false,false,
false,false,true,false,false,false,false,true,false,false,false,false,false,true,true,false,false,false,false,false,
true,true,false,false,false,false,false,true,true,false,false,false,true,false,false,false,false,false,false,false,
false,false,false,false,false,false,false,false,true,false,true,true,false,false,false,false,false,false,false,false,
true,true,true,true,true,true,true,true,true,true,false,false,false,false,false,false,false,false,false,false,
false,false,false,false,false,false,false,false,false,false,false,false,false,false,false,false,false,false,false,false,
false,false,false,false,false,false,false,false,false,false,false,false,false,false,false,false,false,false,false,false,
false,false,false,false,false,false,false,false,false,false,false,false,false,false,false,false,false,false,false,false,
